WWWWWWWWWWWWWWWWWWWWWWWWWWWWWWWWWWWWWWWWWWWWWWWWWWWWWWWWWWWWWWWWW
W,C,-,-,-,-,-,-,-,-,-,-,-,-,-,-,W,-,-,-,-,-,-,-,-,-,-,-,-,-,-,C,W
W,-WWWWWWWWWWWW  WWWWWWWWWWWWW-,W,-WWWWWWWWWWWWW ,WWWWWWWWWWW,-,W
W,-,-,-,-,-,-,-,-,-,-,-,-,-,-,-,-,-,-,-,-,-,-,-,-,-,-,-,-,-,-,-,W
W,-WWWWWWWWWWWW  WW,-,WWWWWWWWWWWWWWWWWWWWW,-,W, ,WWWWWWWWWWW,-,W
W,-,-,-,-,-,-,-,-WW,-,-,-,-,-,-,W,-,-,-,-,-,-,W,-,-,-,-,-,-,-,-,W
W,W,W,W,W,W,W,W, ,WWWWWWWWWWWW-,W,-,WWWWWWWWWWW, ,W-W,W,W,W,W,W,W
W, - , - , - ,W,-,W,-,-,-,-,-,-,C,-,-,-,-,-,-,W,-,W, - , - , - ,W 
WWWWWWWWWWWWWWW  ,W,-,WWWWWWT,T,T,T,TWWWWWW,-,W, ,WWWWWWWWWWWWWWW
-,-,-,-,-,-,-,-,-,-,-,W, , , , , , , , , ,W,-,-,-,-,-,-,-,-,-,-,-
WWWWWWWWWWWWWWW  ,W,-,W, ,G, ,H,I, , ,J, ,W,-,W, ,WWWWWWWWWWWWWWW
W,-,-,-,-,-,-,-,-,-,-,W, , , , , , , , , ,W,-,-,-,-,-,-,-,-,-,-,W
W, WWWWW-WWWWWW, ,W,-,WWWWWWWWWWWWWWWWWWWWW,-,W, ,W,W,W,W,W,W,W,W
W,-, ,-, ,-, ,W,-,W,-,-,-,-,-,-,Y,-,-,-,-,-,-,W,-,W, ,-, ,-, ,-,W
WWWWWWWWWWWWWWW  ,W,W,W,W,W,W,-,W,-,W,W,W,W,W,W,  WWWWWWWWWWWWWWW
W,-,-,-,-,-,-,-,-,W,P,-,-,-,-,-,W,-,-,-,-,-,-,W,-,-,-ñ-,-,-,-,-,W
W,-,W,W,W,W,W,W, ,W,-,W,W,W,W,W,W,W,W,W,W,W,-,W, ,W,W,W,W,W,W,-,W
W,-,-,-,-,-,-,-,-,-,-,-,-,-,-,-,-,-,-,-,-,-,-,-,-,-,-,-,-,-,-,-,W
W,-WWWWWWWWWWWW  ,W,W,W,W,W,W,-,W,-,W,W,W,W,W,W,  WWWWWWWWWWWW-,W
W,C,-,-,-,-,-,-,-,-,-,-,-,-,-,-,W,-,-,-,-,-,-,-,-,-,-,-,-,-,-,C,W
WWWWWWWWWWWWWWWWWWWWWWWWWWWWWWWWWWWWWWWWWWWWWWWWWWWWWWWWWWWWWWWWW
